Slide (feat. Frank Ocean & Migos) | Calvin Harris | Funk Wav Bounces Vol.1
The Weekend - Funk Wav Remix | SZA | The Weekend (Funk Wav Remix)
Kiss Me More (feat. SZA) | Doja Cat | Planet Her
20 Min | Lil Uzi Vert | Luv Is Rage 2 (Deluxe)
Fkn Around (feat. Megan Thee Stallion) | Phony Ppl | Fkn Around (feat. Megan Thee Stallion)
Say So | Doja Cat | Hot Pink
QUE PRETENDES | J Balvin | OASIS
DÁKITI | Bad Bunny | EL ÚLTIMO TOUR DEL MUNDO
Otra Noche en Miami | Bad Bunny | X 100PRE
Solo de Mi | Bad Bunny | X 100PRE
The Box | Roddy Ricch | Please Excuse Me for Being Antisocial
family ties (with Kendrick Lamar) | Baby Keem | family ties (with Kendrick Lamar)
Bichiyal | Bad Bunny | YHLQMDLG
Boss Bitch | Doja Cat | Boss Bitch
Starships | Nicki Minaj | Pink Friday: Roman Reloaded The Re-Up (Explicit Version)
Praise The Lord (Da Shine) (feat. Skepta) | A$AP Rocky | TESTING
Going Bad (feat. Drake) | Meek Mill | Championships
BIG BANK (feat. 2 Chainz, Big Sean, Nicki Minaj) | YG | STAY DANGEROUS
Plain Jane | A$AP Ferg | Still Striving
Tia Tamera (feat. Rico Nasty) | Doja Cat | Amala (Deluxe Version)
WAP (feat. Megan Thee Stallion) | Cardi B | WAP (feat. Megan Thee Stallion)
Way 2 Sexy (with Future & Young Thug) | Drake | Certified Lover Boy
INDUSTRY BABY (feat. Jack Harlow) | Lil Nas X | MONTERO
WHATS POPPIN | Jack Harlow | Sweet Action
Hot Girl Summer (feat. Nicki Minaj & Ty Dolla $ign) | Megan Thee Stallion | Hot Girl Summer (feat. Nicki Minaj & Ty Dolla $ign)
HOT | Daddy Yankee | LEGENDADDY
Replay | Iyaz | Replay
In Da Club | 50 Cent | Get Rich Or Die Tryin'
Fireball (feat. John Ryan) | Pitbull | Globalization
Glad You Came | The Wanted | The Wanted (Special Edition)
Beauty And A Beat | Justin Bieber | Believe (Deluxe Edition)
DJ Got Us Fallin' In Love (feat. Pitbull) | Usher | Raymond v Raymond (Expanded Edition)
Hips Don't Lie (feat. Wyclef Jean) | Shakira | Oral Fixation, Vol. 2 (Expanded Edition)
Come Get Her | Rae Sremmurd | SremmLife
Ni**as In Paris | JAY-Z | Watch The Throne (Deluxe)
Danza Kuduro | Don Omar | Meet The Orphans
Post to Be (feat. Chris Brown & Jhene Aiko) | Omarion | Sex Playlist
ZEZE (feat. Travis Scott & Offset) | Kodak Black | Dying to Live
MONTERO (Call Me By Your Name) | Lil Nas X | MONTERO
Like That (feat. Gucci Mane) | Doja Cat | Hot Pink
Up | Cardi B | Up (Instrumental)
My Type | Saweetie | ICY
Thot Shit | Megan Thee Stallion | Something for Thee Hotties
Body | Megan Thee Stallion | Good News
Tap In | Saweetie | Tap In
Levitating | Dua Lipa | Future Nostalgia
MIA (feat. Drake) | Bad Bunny | MIA (feat. Drake)
Callaita | Bad Bunny | Callaita
I Like It | Cardi B | Invasion of Privacy
Mi Gente | J Balvin | Vibras
Taki Taki (feat. Selena Gomez, Ozuna & Cardi B) | DJ Snake | Carte Blanche
Baila Baila Baila | Ozuna | Nibiru
Havana (feat. Young Thug) | Camila Cabello | Camila
Nice For What | Drake | Scorpion
Feels (feat. Pharrell Williams, Katy Perry & Big Sean) | Calvin Harris | Funk Wav Bounces Vol.1
I Love It (& Lil Pump) | Kanye West | I Love It
TKN (feat. Travis Scott) | ROSALÍA | TKN (feat. Travis Scott)
BOMBÓN | Daddy Yankee | LEGENDADDY
Pepas | Farruko | Pepas
Todo De Ti | Rauw Alejandro | Todo De Ti
Yeah! (feat. Lil Jon & Ludacris) | Usher | Confessions (Expanded Edition)
Five More Hours | Deorro | Five More Hours
Low (feat. T-Pain) | Flo Rida | Mail on Sunday
Promiscuous | Nelly Furtado | Loose
Kiss Me Thru The Phone | Soulja Boy | iSouljaBoyTellem
Whistle | Flo Rida | Whistle
On The Floor - Radio Edit | Jennifer Lopez | On The Floor
Down | Jay Sean | All Or Nothing
#thatPOWER | will.i.am | #willpower (Deluxe)
Crank That (Soulja Boy) | Soulja Boy | souljaboytellem.com
Good Feeling | Flo Rida | Wild Ones
Summer | Calvin Harris | Motion
Shots | LMFAO | Party Rock
My House | Flo Rida | My House
I Know You Want Me (Calle Ocho) | Pitbull | Pitbull Starring In Rebelution
X | Nicky Jam | X
One Dance | Drake | One Dance
One More Time | Daft Punk | Discovery
Still D.R.E. | Dr. Dre | 2001 (Explicit Version)
Yonaguni | Bad Bunny | Yonaguni
La Difícil | Bad Bunny | YHLQMDLG
Heatstroke (feat. Young Thug, Pharrell Williams & Ariana Grande) | Calvin Harris | Funk Wav Bounces Vol.1
Caroline | Aminé | Good For You
Money | Cardi B | Money
Stronger | Kanye West | Graduation
F**kin' Problems (feat. Drake, 2 Chainz & Kendrick Lamar) | A$AP Rocky | LONG.LIVE.A$AP (Deluxe Version)
Controlla | Drake | Views
0 To 100 / The Catch Up | Drake | 0 To 100 / The Catch Up
Trap Queen | Fetty Wap | Trap Queen
God's Plan | Drake | Scary Hours
We Found Love | Rihanna | Talk That Talk (Deluxe)
The Time (Dirty Bit) | Black Eyed Peas | The Beginning (Deluxe)
Gasolina | Daddy Yankee | Barrio Fino (Bonus Track Version)
Play Hard (feat. Ne-Yo & Akon) | David Guetta | Nothing but the Beat 2.0
Levels - Radio Edit | Avicii | Summer BBQ 2020
REMIX | Daddy Yankee | LEGENDADDY
Volví | Aventura | Volví
X ÚLTIMA VEZ | Daddy Yankee | LEGENDADDY
Fiel | Los Legendarios | Los Legendarios 001
Sexy Bitch (feat. Akon) | David Guetta | One More Love
CÓMO SE SIENTE - Remix | Jhay Cortez | LAS QUE NO IBAN A SALIR
Que Calor | Major Lazer | Que Calor
PA' ROMPERLA | Bad Bunny | LAS QUE NO IBAN A SALIR
Loco Contigo (feat. J. Balvin & Tyga) | DJ Snake | Carte Blanche
La Romana | Bad Bunny | X 100PRE
En Mi Cuarto | Jhay Cortez | En Mi Cuarto
De Vuelta Pa' La Vuelta | Daddy Yankee | De Vuelta Pa' La Vuelta
Suavemente | Elvis Crespo | Suavemente...Los Exitos
NI BIEN NI MAL | Bad Bunny | X 100PRE
Odio (feat. Drake) | Romeo Santos | Fórmula, Vol. 2 (Deluxe Edition)
Hotel Room Service | Pitbull | Pitbull Starring In Rebelution
Temperature | Sean Paul | The Trinity
Rude Boy | AZ2A | Rude Boy
L.A.LOVE (la la) [feat. YG] | Fergie | Double Dutchess
Candy Shop | 50 Cent | The Massacre
Taste (feat. Offset) | Tyga | Legendary
Turn Down for What | DJ Snake | Turn Down for What
I Don't Fuck With You | Big Sean | Dark Sky Paradise
Light It Up (feat. Nyla & Fuse ODG) - Remix | Major Lazer | Peace Is the Mission (Extended Edition)
I Took A Pill In Ibiza - Seeb Remix | Mike Posner | At Night, Alone.
Bank Account | 21 Savage | Issa Album
Fake Love | Drake | More Life
Bounce Back | Big Sean | I Decided.
No Limit | G-Eazy | No Limit
Bola Rebola | Tropkillaz | Bola Rebola
Uproar | Lil Wayne | Tha Carter V
Powerglide (feat. Juicy J) - From SR3MM | Rae Sremmurd | SR3MM
All Of The Lights | Kanye West | My Beautiful Dark Twisted Fantasy
3005 | Childish Gambino | Because the Internet
Talk Dirty (feat. 2 Chainz) | Jason Derulo | Talk Dirty
Wiggle (feat. Snoop Dogg) | Jason Derulo | Talk Dirty
Thotiana (Remix) | Blueface | Famous Cryp (Reloaded)
Bodak Yellow | Cardi B | Invasion of Privacy
Juicy | Doja Cat | Hot Pink
HUMBLE. | Kendrick Lamar | DAMN.
I WANNA SEE SOME ASS (feat. jetsonmade) | Jack Harlow | Sweet Action
Touch The Sky | Kanye West | Late Registration
Miami | Will Smith | Big Willie Style
Trampoline (feat. Missy Elliott, BIA and Doechii) | David Guetta | Trampoline (feat. Missy Elliott, BIA and Doechii)
Work It | Missy Elliott | Under Construction
SG (with Ozuna, Megan Thee Stallion & LISA of BLACKPINK) | DJ Snake | SG (with Ozuna, Megan Thee Stallion & LISA of BLACKPINK)
Act Up | City Girls | Girl Code
Uva Bombom | Rochy RD | Uva Bombom
Curazao | El Alfa | Curazao
Guatauba | Plan B | Guatauba XXX
Gimme My Gots | Shardaysa Jones | Gimme My Gots
Sweetest Pie | Megan Thee Stallion | Sweetest Pie
XO Tour Llif3 | Lil Uzi Vert | Luv Is Rage 2
Finesse - Remix; feat. Cardi B | Bruno Mars | Finesse (Remix) [feat. Cardi B]
Los Bobo Son Mio | Haraca Kiko | Los Bobo Son Mio
Bobote | Leo RD | Bobote
Time of Our Lives | Pitbull | Globalization
679 (feat. Remy Boyz) | Fetty Wap | 679 (feat. Remy Boyz)
Twerk (feat. Cardi B) | City Girls | Girl Code
Get Busy | Sean Paul | Dutty Rock
Buy U a Drank (Shawty Snappin') (feat. Yung Joc) | T-Pain | Epiphany (Expanded Edition)
Bitch Better Have My Money | Rihanna | Bitch Better Have My Money
Rack City | Tyga | Careless World: Rise Of The Last King
La Mamá de la Mamá | El Alfa | La Mamá de la Mamá
Bartier Cardi (feat. 21 Savage) | Cardi B | Invasion of Privacy
All The Way Up | Fat Joe | Plata O Plomo
Birthday Sex | Jeremih | Jeremih
Con Calma | Daddy Yankee | Con Calma
Cash Out (feat. ScHoolboy Q, PARTYNEXTDOOR & D.R.A.M.) | Calvin Harris | Funk Wav Bounces Vol.1
Jackie Chan | Tiësto | Jackie Chan
Pursuit Of Happiness - Extended Steve Aoki Remix | Kid Cudi | Pursuit Of Happiness [Extended Steve Aoki Remix (Explicit)]
This Is What You Came For (feat. Rihanna) | Calvin Harris | This Is What You Came For (feat. Rihanna)
The Nights | Avicii | EDM Hits
Like A G6 | Far East Movement | Free Wired
Memories (feat. Kid Cudi) - 2021 Remix | David Guetta | Memories (feat. Kid Cudi) [2021 Remix]
Broken Arrows | Avicii | Stories
Serotonin - Radio Mix | Audien | Serotonin (Radio Mix)
Magic (feat. Nile Rodgers and Brandy) | Mystery Skulls | Forever
Both Wrong | Dawin | Both Wrong
Hood Go Crazy | Tech N9ne | Special Effects
Throw Fits (feat. City Girls & Juvenile) | London On Da Track | Throw Fits (feat. City Girls & Juvenile)
4AM | Manny Norté | 4AM
One Kiss (with Dua Lipa) | Calvin Harris | One Kiss (with Dua Lipa)
Feel So Close - Radio Edit | Calvin Harris | 18 Months
Let's Go (feat. Ne-Yo) | Calvin Harris | 18 Months
Under Control (feat. Hurts) | Calvin Harris | Motion
The Nights | Avicii | The Days / Nights
Wake Me Up | Avicii | True
Waiting For Love | Avicii | Stories
Levels - Radio Edit | Avicii | Levels
Hey Brother | Avicii | True
I Could Be The One (Avicii Vs. Nicky Romero) - Radio Edit | Avicii | I Could Be The One [Avicii vs Nicky Romero]
Addicted To You | Avicii | True
Sunshine | David Guetta | Nothing but the Beat (Ultimate Edition)
A Sky Full of Stars | Coldplay | Ghost Stories
Liar Liar | Avicii | True
Clarity | Zedd | Clarity
Follow | Martin Garrix | Follow
Stay The Night - Featuring Hayley Williams Of Paramore | Zedd | Clarity (Deluxe)
Find You | Zedd | Find You
Break Free | Ariana Grande | My Everything (Deluxe)
Lost At Sea | Zedd | Clarity
You Make Me Feel... (feat. Sabi) | Cobra Starship | Night Shades
Save The World | Swedish House Mafia | Save The World
Calling (Lose My Mind) - Radio Edit | Sebastian Ingrosso | Calling (Lose My Mind)
Lights | Steve Angello | Until Now
I Could Be The One [Avicii vs Nicky Romero] - Nicktim - Radio Edit | Avicii | I Could Be The One [Avicii vs Nicky Romero]
Mama Look at Me Now | Galantis | Satisfied (feat. MAX) / Mama Look at Me Now
Bedroom Floor - Cash Cash Remix | Liam Payne | Bedroom Floor (Cash Cash Remix)
Summer Days (feat. Macklemore & Patrick Stump of Fall Out Boy) | Martin Garrix | Summer Days (feat. Macklemore & Patrick Stump of Fall Out Boy)
Buzzing (with Nevve) | Audien | Buzzing (with Nevve)
Never Be The Same | Tritonal | Never Be The Same
Circles | Audien | Circles
Craving | ARTY | Craving
Dance It Off - Thomas Nan Remix | Laidback Luke | Dance It Off (Thomas Nan Remix)
Pressure (feat. Tove Lo) | Martin Garrix | Pressure (feat. Tove Lo)
One Night Away | ARTY | One Night Away
Take Your Time | ARTY | Take Your Time
Peanut Butter Jelly | Galantis | Pharmacy
Runaway (U & I) | Galantis | Pharmacy
Thinking About You (feat. Ayah Marar) | Calvin Harris | 18 Months
Silhouettes - Original Radio Edit | Avicii | Silhouettes
Secrets - Radio Edit | Tiësto | Secrets (Radio Edit)
Evacuate The Dancefloor | Cascada | Evacuate The Dancefloor
Addiction (feat. Lil Wayne & Saweetie) | Big K.R.I.T. | K.R.I.T. IZ HERE
Bad Vibe | M.O | Bad Vibe
California Love - Original Version | 2Pac | The Best of 2Pac
The Devil Is A Lie | Rick Ross | Mastermind (Deluxe)
Haute (feat. J Balvin & Chris Brown) | Tyga | Haute (feat. J Balvin & Chris Brown)
Heartless | Kanye West | 808s & Heartbreak
Lemon (feat. Drake) - Drake Remix | N.E.R.D | Lemon (feat. Drake) [Drake Remix]
Love$ick (feat. A$AP Rocky) | Mura Masa | Mura Masa
Look Alive (feat. Drake) | BlocBoy JB | Look Alive (feat. Drake)
Soco (feat. Wizkid, Ceeza Milli, Spotless & Terri) | StarBoy | Soco (feat. Wizkid, Ceeza Milli, Spotless & Terri)
Starships | Nicki Minaj | Pink Friday ... Roman Reloaded
Trap Queen | Fetty Wap | Fetty Wap (Deluxe)
Va Va Voom | Nicki Minaj | Pink Friday ... Roman Reloaded (Deluxe Edition)
Boneless | Steve Aoki | Boneless (Remixes)
Born To Rage - USA Version | Dada Life | Born To Rage
Kick Out The Epic Motherf**ker | Dada Life | The Rules Of Dada
Feed The Dada | Dada Life | The Rules Of Dada
Rolling Stones T-Shirt | Dada Life | The Rules Of Dada
Freaks Have More Fun - Radio Edit | Dada Life | Freaks Have More Fun
Ghosts 'n' Stuff (feat. Rob Swire) - Radio Edit | deadmau5 | Ghosts 'n' Stuff (feat. Rob Swire) (feat. Rob Swire)
Liar Liar - Avicii By Avicii | Avicii | True: Avicii By Avicii
Beautiful Now | Zedd | True Colors
Toulouse (2020 Edit) | Nicky Romero | Toulouse (2020 Edit)
Toulouse | Nicky Romero | Miami 2012 (Mixed by MYNC & Nicky Romero)
Get Lucky (feat. Pharrell Williams & Nile Rodgers) | Daft Punk | Random Access Memories
One More (feat. Nile Rodgers) | SG Lewis | times
Feed The Fire - Kassian Remix | SG Lewis | Feed The Fire (Kassian Remix)
Chemicals | SG Lewis | times
Don't Start Now | Dua Lipa | Future Nostalgia
Break My Heart | Dua Lipa | Future Nostalgia
Feed The Fire (feat. Lucky Daye) | SG Lewis | Feed The Fire (feat. Lucky Daye)
Gucci Slides (feat. LORYN) | Boston Bun | Gucci Slides
Juice - Breakbot Mix | Lizzo | Juice (Breakbot Mix)
777 | Bruno Mars | An Evening With Silk Sonic
Like Sugar | Chaka Khan | Like Sugar - EP
